10 10 10 10 10 10 10 10 10 10 10 10 10 10 10 10 10 10 10 10 10 10 10 10 10 10 10 10 10 10 10 10 10 10 10 10 10 10 10 10 10 10 10 10 10 10 10 10 10 10
10 05 05 05 05 05 05 05 05 05 05 05 05 05 05 05 05 05 05 05 05 05 05 05 05 05 05 05 05 05 05 05 05 05 05 05 05 05 05 05 05 05 05 05 05 05 05 05 05 10
10 05 30 30 30 30 30 30 30 30 30 30 30 30 30 30 30 30 30 30 30 30 30 30 30 30 30 30 30 30 30 30 30 30 30 30 30 30 30 30 30 30 30 30 30 30 30 30 05 10
10 05 30 40 40 40 40 40 30 30 30 30 30 30 30 30 30 30 30 30 30 30 30 30 30 30 30 30 30 30 30 30 30 30 30 30 30 30 30 30 30 30 30 30 30 30 30 30 05 10
10 05 30 40 06 06 06 40 30 30 30 30 30 30 30 30 30 30 30 30 30 30 30 30 30 30 30 30 30 30 30 30 30 30 30 30 30 30 30 30 30 30 30 30 30 30 30 30 05 10
10 05 30 40 06 06 06 40 30 30 30 30 30 30 30 30 30 30 30 30 30 30 30 30 30 30 30 30 30 30 30 30 30 30 30 30 30 30 30 30 30 30 30 30 30 30 30 30 05 10
10 05 30 40 06 06 06 40 30 30 30 30 30 30 30 30 30 30 30 30 30 30 30 30 30 30 30 30 30 30 30 30 30 30 30 30 30 30 30 30 30 30 30 30 30 30 30 30 05 10
10 05 30 40 40 06 40 40 30 30 30 30 30 30 30 30 30 30 30 30 30 30 30 30 30 30 30 30 30 30 30 30 30 30 30 30 30 30 30 30 30 30 30 30 30 30 30 30 05 10
10 05 30 35 35 02 35 35 30 30 30 30 30 30 30 30 30 30 30 30 30 30 30 30 30 30 30 30 30 30 30 30 30 30 30 30 30 30 30 30 30 30 30 30 30 30 30 30 05 10
10 05 30 37 37 02 37 37 30 30 30 30 30 30 30 30 30 30 30 30 30 30 30 30 30 30 30 30 30 30 30 30 30 30 30 30 30 30 30 30 30 30 30 30 30 30 30 30 05 10
10 05 30 30 30 02 30 30 30 30 30 30 30 30 30 30 30 30 30 30 30 30 30 30 30 30 30 30 30 30 30 30 30 30 30 30 30 30 30 30 30 30 30 30 30 30 30 30 05 10
10 05 30 30 00 02 00 00 30 30 30 30 30 30 30 30 30 30 30 30 30 30 30 30 30 30 30 30 30 30 30 30 30 30 30 30 30 30 30 30 30 30 30 30 30 30 30 30 05 10
10 05 30 30 00 02 00 00 30 30 30 30 30 30 30 30 30 30 30 30 30 30 30 30 30 30 30 30 30 30 30 30 30 30 30 30 30 30 30 30 30 30 30 30 30 30 30 30 05 10
10 05 30 30 00 02 00 30 30 30 30 30 30 30 30 30 30 30 30 30 30 30 30 30 30 30 30 30 30 30 30 30 30 30 30 30 30 30 30 30 30 30 30 30 30 30 30 30 05 10
10 05 30 30 00 02 00 30 30 30 30 30 30 30 30 30 30 30 30 30 30 30 30 30 30 30 30 30 30 30 30 30 30 30 30 30 30 30 30 30 30 30 30 30 30 30 30 30 05 10
10 05 30 30 00 02 00 30 30 30 30 30 30 30 30 30 30 30 30 30 30 30 30 30 30 30 30 30 30 30 30 30 30 30 30 30 30 30 30 30 30 30 30 30 30 30 30 30 05 10
10 05 30 30 00 02 00 30 30 30 30 30 30 30 30 30 30 30 30 30 30 30 30 30 30 30 30 30 30 30 30 30 30 30 30 30 30 30 30 30 30 30 30 30 30 30 30 30 05 10
10 05 30 30 30 02 30 30 30 30 30 30 30 30 30 30 30 30 30 30 30 30 30 30 30 30 30 30 30 30 30 30 30 30 30 30 30 30 30 30 30 30 30 30 30 30 30 30 05 10
10 05 30 30 30 02 30 30 30 30 30 30 30 30 30 30 30 30 30 30 30 30 30 30 30 30 30 30 30 30 30 30 30 30 30 30 30 30 30 30 30 30 30 30 30 30 30 30 05 10
10 05 30 30 30 02 30 30 30 30 30 30 30 30 30 30 30 30 30 30 30 30 30 30 30 30 30 30 30 30 30 30 30 30 30 30 30 30 30 30 30 30 30 30 30 30 30 30 05 10
10 05 30 30 30 02 30 30 30 30 30 30 30 30 30 30 30 30 30 30 30 30 30 30 30 30 30 30 30 30 30 30 30 30 30 30 30 30 30 30 30 30 30 30 30 30 30 30 05 10
10 05 30 30 30 02 30 30 30 30 30 30 30 30 30 30 30 30 30 30 30 30 30 30 30 30 30 30 30 30 30 30 30 30 30 30 30 30 30 30 30 30 30 30 30 30 30 30 05 10
10 05 30 30 30 02 30 30 30 30 30 30 30 30 30 30 30 30 30 30 30 30 30 30 30 30 30 30 30 30 30 30 30 30 30 30 30 30 30 30 30 30 30 30 30 30 30 30 05 10
10 05 30 30 30 02 02 02 02 02 30 30 30 30 30 30 30 30 30 30 30 30 30 30 30 30 30 30 30 30 30 30 30 30 30 30 30 30 30 30 30 30 30 30 30 30 30 30 05 10
10 05 30 30 30 30 30 30 30 02 30 30 30 30 30 30 30 30 30 30 30 30 30 30 30 30 30 30 30 30 30 30 30 30 30 30 30 30 30 30 30 30 30 30 30 30 30 30 05 10
10 05 30 30 30 30 30 30 30 02 30 30 30 30 30 30 30 30 30 30 30 30 30 30 30 30 30 30 30 30 30 30 30 30 30 30 30 30 30 30 30 30 30 30 30 30 30 30 05 10
10 05 30 30 30 30 30 30 30 02 30 30 30 30 30 30 30 30 30 30 30 30 30 30 30 30 30 30 30 30 30 30 30 30 30 30 30 30 30 30 30 30 30 30 30 30 30 30 05 10
10 05 30 30 30 30 30 30 30 02 30 30 30 30 30 30 30 30 30 30 30 30 30 30 30 30 30 30 30 30 30 30 30 30 30 30 30 30 30 30 30 30 30 30 30 30 30 30 05 10
10 05 30 30 30 30 30 30 30 02 30 30 30 30 30 30 30 30 30 30 30 30 30 30 30 30 30 30 30 30 30 30 30 30 30 30 30 30 30 30 30 30 30 30 30 30 30 30 05 10
10 05 30 02 02 02 02 02 02 02 30 30 30 30 30 30 30 30 30 30 30 30 30 30 30 30 30 30 30 30 30 30 30 30 30 30 30 30 30 30 30 30 30 30 30 30 30 30 05 10
10 05 30 02 30 30 30 30 30 30 30 30 30 30 30 30 30 30 30 30 30 30 30 30 30 30 30 30 30 30 30 30 30 30 30 30 30 30 30 30 30 30 30 30 30 30 30 30 05 10
10 05 30 02 30 30 30 30 30 30 30 30 30 30 30 30 30 30 30 30 30 30 30 30 30 30 30 30 30 30 30 30 30 30 30 30 30 30 30 30 30 30 30 30 30 30 30 30 05 10
10 05 30 02 30 30 30 30 30 30 30 30 30 30 30 30 30 30 30 30 30 30 30 30 30 30 30 30 30 30 30 30 30 30 30 30 30 30 30 30 30 30 30 30 30 30 30 30 05 10
10 05 30 02 30 30 30 30 30 30 30 30 30 30 30 30 30 30 30 30 30 30 30 30 40 40 40 40 40 30 30 30 30 30 30 30 30 30 30 30 30 30 30 30 30 30 30 30 05 10
10 05 30 02 30 30 30 30 30 30 30 30 30 30 30 30 30 30 30 30 30 30 30 30 40 06 06 06 40 30 30 30 30 30 30 30 30 30 30 30 30 30 30 30 30 30 30 30 05 10
10 05 30 02 30 30 30 30 30 30 30 30 30 30 30 30 30 30 30 30 30 30 30 30 40 06 06 06 40 30 30 30 30 30 30 30 30 30 30 30 30 30 30 30 30 30 30 30 05 10
10 05 30 02 30 30 30 30 30 30 30 30 30 30 30 30 30 30 30 30 30 30 30 30 40 06 06 06 40 30 30 30 30 30 30 30 30 30 30 30 30 30 30 30 30 30 30 30 05 10
10 05 30 02 30 30 30 30 30 30 30 30 30 30 30 30 30 30 30 30 30 30 30 30 40 40 06 40 40 30 30 30 30 30 30 30 30 30 30 30 30 30 30 30 30 30 30 30 05 10
10 05 30 02 30 30 30 30 30 30 30 30 30 30 30 30 30 30 30 30 30 30 30 30 30 00 02 00 30 30 30 30 30 30 30 30 30 30 30 30 30 30 30 30 30 30 30 30 05 10
10 05 30 02 30 30 30 30 30 30 30 30 30 30 30 30 30 30 30 30 30 30 30 30 30 00 02 00 30 30 30 30 30 30 30 30 30 30 30 30 30 30 30 30 30 30 30 30 05 10
10 05 00 02 00 40 40 40 40 40 40 40 00 00 30 30 30 30 30 30 30 30 30 30 30 00 02 00 30 30 30 30 30 30 30 30 30 30 30 30 30 30 30 30 30 30 30 30 05 10
10 05 00 02 00 40 06 06 06 06 06 40 00 00 30 30 30 30 30 30 30 30 30 30 30 00 02 00 30 30 30 30 30 30 30 30 30 30 30 30 30 30 30 30 30 30 30 30 05 10
10 05 00 02 00 40 06 06 06 06 06 40 00 00 30 30 30 30 30 30 30 30 30 30 30 00 02 00 30 30 30 30 30 30 30 30 30 30 30 30 30 30 30 30 30 30 30 30 05 10
10 05 00 02 00 40 06 06 06 06 06 40 00 00 30 30 30 30 30 30 30 30 30 30 30 00 02 00 30 30 30 30 30 30 30 30 30 30 30 30 30 30 30 30 30 30 30 30 05 10
10 05 00 02 00 40 06 40 40 40 40 40 00 00 30 30 30 30 30 30 30 30 30 30 30 00 02 00 30 30 30 30 30 30 30 30 30 30 30 30 30 30 30 30 30 30 30 30 05 10
10 05 00 02 00 00 00 00 00 00 00 00 00 00 00 00 00 00 00 00 00 00 00 00 00 00 02 00 00 00 00 30 30 30 30 30 30 30 30 30 30 30 30 30 30 30 30 30 05 10
10 05 00 02 02 02 02 02 02 02 02 02 02 02 02 02 02 02 02 02 02 02 02 02 02 02 02 02 02 02 02 30 30 30 30 30 30 30 30 30 30 30 30 30 30 30 30 30 05 10
10 05 00 00 00 00 00 00 00 00 00 00 00 00 00 00 00 00 00 00 00 00 00 00 00 00 00 00 00 00 00 30 30 30 30 30 30 30 30 30 30 30 30 30 30 30 30 30 05 10
10 05 05 05 05 05 05 05 05 05 05 05 05 05 05 05 05 05 05 05 05 05 05 05 05 05 05 05 05 05 05 05 05 05 05 05 05 05 05 05 05 05 05 05 05 05 05 05 05 10
10 10 10 10 10 10 10 10 10 10 10 10 10 10 10 10 10 10 10 10 10 10 10 10 10 10 10 10 10 10 10 10 10 10 10 10 10 10 10 10 10 10 10 10 10 10 10 10 10 10