10 10 10 10 10 10 10 10 10 10 10 10 10 10 10 10 10 10 10 10 10 10 10 10 10 10 10 10 10 10 10 10 10 10 10 10 10 10 10 10 10 10 10 10 10 10 10 10 10 10
10 05 05 05 05 05 05 05 05 05 05 05 05 05 05 05 05 05 05 05 05 05 05 05 05 05 05 05 05 05 05 05 05 05 05 05 05 05 05 05 05 05 05 05 05 05 05 05 05 10
10 05 30 30 30 30 30 30 30 30 30 30 30 30 30 30 30 30 30 30 30 30 30 30 30 30 30 30 30 30 30 30 30 30 30 30 30 30 30 30 30 30 00 00 00 00 00 30 05 10
10 05 30 40 40 40 40 40 30 30 30 30 30 30 30 30 30 30 30 30 30 30 30 30 30 30 30 30 30 30 30 30 30 30 30 30 30 30 30 30 30 00 00 00 41 00 00 00 05 10
10 05 30 40 06 06 06 40 30 30 30 30 30 30 30 30 30 30 30 30 30 30 30 30 30 30 30 30 30 30 30 30 30 30 30 30 30 30 30 30 30 00 00 41 41 41 00 00 05 10
10 05 30 40 06 06 06 40 30 30 30 30 30 30 30 30 30 30 30 30 30 30 30 30 30 30 30 30 30 30 30 30 30 30 30 30 30 30 30 30 30 00 41 41 41 41 41 00 05 10
10 05 30 40 06 06 06 40 30 30 30 30 30 30 30 30 30 30 30 30 30 30 30 30 30 30 30 30 30 30 30 30 30 30 30 30 30 30 30 30 30 00 41 41 41 41 41 00 05 10
10 05 30 40 40 06 40 40 30 30 30 30 30 30 30 30 30 30 30 30 30 30 30 30 30 30 30 30 30 30 30 30 30 30 30 30 30 30 30 30 30 00 41 41 50 41 41 00 05 10
10 05 30 00 00 02 00 00 30 30 30 30 30 30 30 30 30 30 30 30 30 30 30 30 30 30 30 30 30 30 30 30 30 30 30 30 30 30 30 30 30 00 00 00 02 00 00 00 05 10
10 05 30 00 00 02 00 00 30 30 30 30 30 30 30 30 30 30 30 30 30 30 30 30 30 30 30 30 30 30 30 30 30 30 30 30 30 30 30 30 30 30 00 00 02 00 00 30 05 10
10 05 30 30 30 02 30 30 30 30 30 30 30 00 04 04 04 04 04 04 04 04 04 04 04 04 04 04 04 04 04 04 04 04 30 30 30 30 30 30 30 30 30 00 02 00 30 30 05 10
10 05 30 30 00 02 00 00 30 30 30 30 30 35 00 35 35 35 35 35 35 35 35 35 35 35 35 35 35 35 35 35 35 04 30 30 30 30 30 30 30 30 30 00 02 00 30 30 05 10
10 05 30 30 00 02 00 00 30 30 30 30 30 35 00 37 00 00 00 00 00 00 00 00 00 00 00 00 00 00 35 00 35 04 30 30 30 30 30 30 30 30 30 00 02 00 30 30 05 10
10 05 30 30 00 02 00 30 30 30 30 30 30 35 00 37 00 37 37 37 37 37 37 37 37 37 37 37 37 00 00 00 35 04 30 30 30 30 30 30 30 30 30 00 02 00 30 30 05 10
10 05 30 30 00 02 00 30 30 30 30 30 30 35 00 37 00 37 00 00 00 00 00 00 00 00 40 00 37 00 37 00 35 04 30 30 30 30 30 30 30 30 30 00 02 00 30 30 05 10
10 05 30 30 00 02 00 30 30 30 30 30 30 35 00 37 00 37 00 40 40 40 40 40 40 00 40 00 37 00 37 00 35 04 30 30 30 30 30 30 30 30 30 00 02 00 30 30 05 10
10 05 30 30 00 02 00 30 30 30 30 30 30 35 00 37 00 37 00 40 00 00 00 00 40 00 40 00 37 00 37 00 35 04 30 30 30 30 30 30 30 30 30 00 02 00 30 30 05 10
10 05 30 30 30 02 30 30 30 30 30 30 30 35 00 37 00 37 00 40 00 40 40 00 40 00 40 00 37 00 37 00 35 04 30 30 30 30 30 30 30 30 30 00 02 00 30 30 05 10
10 05 30 30 30 02 30 30 30 30 30 30 30 35 00 37 00 37 00 40 00 40 00 00 40 00 40 00 37 00 37 00 35 04 30 30 30 30 30 30 30 30 30 00 02 00 30 30 05 10
10 05 30 30 30 02 30 30 30 30 30 30 30 35 00 37 00 37 00 40 00 40 00 00 40 00 40 00 37 00 37 00 35 04 30 30 30 30 30 30 30 30 30 00 02 00 30 30 05 10
10 05 30 30 30 02 30 30 30 30 30 30 30 35 00 37 00 37 00 40 00 40 40 40 40 00 40 00 37 00 37 00 35 04 30 30 30 30 30 30 30 30 00 00 02 00 30 30 05 10
10 05 30 30 30 02 30 30 30 30 30 30 30 35 00 37 00 37 00 40 00 00 00 00 00 00 40 00 37 00 37 00 35 04 00 30 30 30 30 30 30 00 00 00 02 00 30 30 05 10
10 05 30 30 30 02 30 30 30 30 30 30 30 35 00 37 00 37 00 40 40 40 40 40 40 40 40 00 37 00 37 00 35 04 00 00 30 30 30 30 00 00 00 00 02 00 30 30 05 10
10 05 30 30 30 02 02 02 02 02 30 30 30 35 00 37 00 37 04 04 04 04 04 04 04 04 00 00 37 00 37 00 35 04 00 00 00 00 00 00 00 00 00 00 02 00 30 30 05 10
10 05 30 30 30 30 30 30 00 02 30 30 30 35 00 37 00 37 37 37 37 37 37 37 37 37 00 37 37 00 37 00 35 02 02 02 02 02 02 02 02 02 02 02 02 00 30 30 05 10
10 05 30 30 30 30 30 30 30 02 30 30 30 35 00 37 00 00 00 00 00 00 00 00 00 00 00 37 00 00 37 00 35 00 00 00 00 00 00 00 00 00 00 00 02 00 30 30 05 10
10 05 30 30 30 30 30 30 30 02 30 30 30 35 00 37 37 37 37 37 37 37 37 37 37 37 37 37 37 37 37 00 35 00 00 00 30 30 30 30 00 00 00 00 02 00 30 30 05 10
10 05 30 30 30 30 30 30 30 02 30 30 30 35 00 00 00 00 00 00 00 00 00 00 00 00 00 00 00 00 00 00 35 00 00 30 30 30 30 30 30 00 00 00 02 00 30 30 05 10
10 05 30 30 30 30 30 30 00 02 30 30 30 35 35 35 35 35 35 35 35 35 35 35 35 35 35 35 35 35 35 35 35 00 30 30 30 30 30 30 30 30 00 00 02 00 30 30 05 10
10 05 30 02 02 02 02 02 02 02 30 30 30 00 00 00 00 00 00 00 00 00 00 00 00 00 00 00 00 00 00 00 00 00 30 30 30 30 30 30 30 30 30 00 02 00 30 30 05 10
10 05 30 02 00 30 30 30 30 30 30 30 30 30 30 30 30 30 30 30 30 30 30 30 30 30 30 30 30 30 30 30 30 30 30 30 30 30 30 30 30 30 30 00 02 00 30 30 05 10
10 05 30 02 30 30 30 30 30 30 30 30 30 30 30 30 30 30 30 30 30 30 30 30 30 30 30 30 30 30 30 30 30 30 30 30 30 30 30 30 30 30 30 00 02 00 30 30 05 10
10 05 30 02 30 30 30 30 30 30 30 30 30 30 30 30 30 30 30 30 30 30 30 30 30 30 30 30 30 30 30 30 30 30 30 30 30 30 30 30 30 30 30 00 02 00 30 30 05 10
10 05 30 02 30 30 30 30 30 30 30 30 30 30 30 30 30 30 30 30 30 30 30 30 40 40 40 40 40 30 30 30 30 30 30 30 30 30 30 30 30 30 30 00 02 00 30 30 05 10
10 05 30 02 30 30 30 30 30 30 30 30 30 30 30 30 30 30 30 30 30 30 30 30 40 06 06 06 40 30 30 30 30 30 30 30 30 30 30 30 30 30 30 00 02 00 30 30 05 10
10 05 30 02 30 30 30 30 30 30 30 30 30 30 30 30 30 30 30 30 30 30 30 30 40 06 06 06 40 30 30 30 30 30 30 30 30 30 30 30 30 30 30 00 02 00 30 30 05 10
10 05 30 02 30 30 30 30 30 30 30 30 30 30 30 30 30 30 30 30 30 30 30 30 40 06 06 06 40 30 30 30 30 30 30 30 30 30 30 30 30 30 30 00 02 00 30 30 05 10
10 05 30 02 30 30 30 30 30 30 30 30 30 30 30 30 30 30 30 30 30 30 30 30 40 40 06 40 40 30 30 30 30 30 30 30 30 30 30 30 30 30 30 00 02 00 30 30 05 10
10 05 30 02 30 30 30 30 30 30 30 30 30 30 30 30 30 30 30 30 30 30 30 30 30 00 02 00 30 30 30 30 30 30 30 30 30 30 30 30 30 30 30 00 02 00 30 30 05 10
10 05 30 02 30 30 30 30 30 30 30 30 30 30 30 30 30 30 30 30 30 30 30 30 30 00 02 00 30 30 30 30 30 30 30 30 30 30 30 30 30 30 30 00 02 00 30 30 05 10
10 05 00 02 00 40 40 40 40 40 40 40 00 00 30 30 30 30 30 30 30 30 30 30 30 00 02 00 30 30 30 30 30 30 30 30 30 30 30 30 30 30 30 00 02 00 30 30 05 10
10 05 00 02 00 40 06 06 06 06 06 40 00 00 30 30 30 30 30 30 30 30 30 30 30 00 02 00 30 30 30 30 30 30 30 30 30 30 30 30 30 30 30 00 02 00 30 30 05 10
10 05 00 02 00 40 06 06 06 06 06 40 00 00 30 30 30 30 30 30 30 30 30 30 30 00 02 00 30 30 30 30 30 30 30 30 30 30 30 30 30 30 00 00 02 00 30 30 05 10
10 05 00 02 00 40 06 06 06 06 06 40 00 00 30 30 30 30 30 30 30 30 30 30 30 00 02 00 30 30 30 30 30 30 30 30 30 30 30 30 30 00 00 00 02 00 30 30 05 10
10 05 00 02 00 40 06 40 40 40 40 40 00 00 30 30 30 30 30 30 30 30 30 30 00 00 02 00 00 30 30 30 30 30 30 30 30 30 30 30 00 00 00 00 02 00 30 30 05 10
10 05 00 02 00 00 00 00 00 00 00 00 00 00 00 00 00 00 00 00 00 00 00 00 00 00 02 00 00 00 00 00 00 00 00 00 00 00 00 00 00 00 00 00 02 00 30 30 05 10
10 05 00 02 02 02 02 02 02 02 02 02 02 02 02 02 02 02 02 02 02 02 02 02 02 02 02 02 02 02 02 02 02 02 02 02 02 02 02 02 02 02 02 02 02 00 30 30 05 10
10 05 00 00 00 00 00 00 00 00 00 00 00 00 00 00 00 00 00 00 00 00 00 00 00 00 00 00 00 00 00 00 00 00 00 00 00 00 00 00 00 00 00 00 00 00 30 30 05 10
10 05 05 05 05 05 05 05 05 05 05 05 05 05 05 05 05 05 05 05 05 05 05 05 05 05 05 05 05 05 05 05 05 05 05 05 05 05 05 05 05 05 05 05 05 05 05 05 05 10
10 10 10 10 10 10 10 10 10 10 10 10 10 10 10 10 10 10 10 10 10 10 10 10 10 10 10 10 10 10 10 10 10 10 10 10 10 10 10 10 10 10 10 10 10 10 10 10 10 10